20
##..#####.#######.##
#....#....##.#.....#
#..#...##....##..###
...#.###..#..G#..##.
.#.###.########..##.
##.......#.#........
...#.#..##.#.###.##.
#.####.....#..#...##
#.#.#...#####.......
#.#####.#...###.###.
....#...#.S.....#.#.
#.###.###...###.#...
#..#..#.##.##.#####.
...#.....#.......#..
##....#..#....##.#..
...#.######.###....#
#.##.#..###......###
..........##.##.....
#..#.##.#..#.###.##.
####.#..##...##..#..
