10
G#....#S..
.##.#####.
.......##.
#.###.###.
#.#.#.#.#.
#.....#...
#####...#.
.##.#.###.
.##...#.#.
....###...