8
S...#...
###.###.
..#.....
.##.####
......#G
###.###.
#.#.....
#...####
